16 8
0 0 0 0 0 0 2 2 0 0 0 0 0 0 0 0
0 0 4 4 4 4 2 2 4 4 4 4 4 4 0 0
0 0 4 3 2 2 2 2 2 2 2 3 2 4 0 0
0 0 4 2 2 2 2 3 2 2 2 2 2 4 0 0
0 0 4 2 2 2 2 2 2 2 2 2 1 4 0 0
0 0 4 2 3 2 2 2 2 2 2 1 1 4 0 0
0 0 4 4 4 4 4 4 4 4 4 4 4 4 0 0
0 0 0 0 0 0 0 0 0 0 0 0 0 0 0 0
